WWWWWWWWWWWWWWWWWWWWWWWWWWWWWWWWWWWWWWWW
WGGGGGTTTGGGGGGGGGGGGGGGGGGGGGGGGGGGGGGW
WGGGGGTTTGGGGGGGGGGGGGGGGGGTTTTTTTTTtTGW
WGGGGGTTTG[-----]GGGGGGGGGTTTTGGGGGGGTGW
WGGGGGTTTG/LLLLL|GGGGGGTGGTTTTGGGGGGGtGW
WGGGGGTTTG/LLLLL|GGGGGTTGGTTTTGGTTTTTTGW
WGGGGGTTTG{_____}GGGGTTTGGTTTTGGGGGGGGGW
WGGGGGGTTGGGGGGGGGGGGTTTGGTTTTGGGGGGGGGW
WGGGGGGGTGGGGGGGGGGGGTTTGGGTTTTTTTTTTTtW
WGGGGGGGTGGGGGGGGGGGGTTTGGGGGGGGGGGGGGGW
WGGGGGGGGGGGGGGGGGGGGTTTGGGGGGGGGGGGGGGW
WGGGGGGGGGGGTTTTTTTTTTTTGGGGGGGGGGGGGGGW
WGGGGTTTTTTTTTTTTTTTTTTTGG[---------]GGW
WGGGTTTTTTTTTTTTTTTTTTTTGG/LLLLLLLLL|GGW
WGGGTTGGGGGGGGGGGGGGGTTTGG/LLLLLLLLL|GGW
WGGGTTTGG[---]GGTTGGGGTTGG/LLLLLLLLL|GGW
WGGGTTTGG{___}GGTTGGGGGTGG/LLLLLLLLL|GGW
WGGGTTTGGGGGGGGGTTGGGGGTGG/LLLLLLLLL|GGW
WGGGTTTTTTTTTTTtTTGGGGGTGG/LLLLLLLLL|GGW
WGGGGTTTTTTTTTTTtGGGGGGTGG{_________}GGW
WGGGGGGGGGGGGGGGGGGGGGGTGGGGGGGGGGGGGGGW
WWWWWWWWWWWWWWWWWWWWWWWWWWWWWWWWWWWWWWWW